&&&&&&&&&&
&##&###&#&
&##&###&#&
&####&&##&
&#&&&####&
&###&####&
&#&###&##&
&#&&&#&&#&
&&#######&
&&&&&&&&&&